32332312131222223312321113323321212121223231221313322121133213333221312111331332

32123213332111111211231111331222331322111321331133112322112112323113223333322312

23333231332323122313322331222332213212321113121212231233233133322131112111223322

31212313213122323233321213331313233113313331131223112231212232132233322223332222

22211232233223213321133113311212323232121333111313312222311211221111133321332232

13121212121333212231133322333131132311323213233113111323313313231231232232113322

32211312113333223213313121212332232112111323333222121213313311312231212213123222

33112222333233131311121132223322111232113331122211323121322322223323112322113212

23211321322311333223123321111121112112211133132113131312122311122332122221221222

12223113233321312311322132121123211322332121322311311313232121231222133211113232

31233333212222122112333112321313221111223112323333223211221232211231322231333212

11212232223113213212223123212232213112321331221333213221222233211133211121313312

32121211111312232133111221333211211113312123121123223331332222121323313322232112

33112331333122231223123123213212133131221213231311231132312112122222233313113312

11223221323333331223111212213333231222131221322331131333231213311212132321233212

22123121221122322311223133223212122313232233111312333113112322221133111233131322

22223322222122111122211311222221211222122212111331213211111332222231231332331322

32312111133221133123221223311133231122233333331332321123311312321233221232121132

21112131231232122332213112311332231123132231313312213132133222223212322211232322

13131223232121331323333112112121131121231312313222133131321212321311113232111112

23221121323121221322221223131212231313212121212231311321323123113132331333333212

31233132233233332131323332211322313222221333232221231333111123332313331212231122

33121111321221123322232113112111213322312333321231321332131222123311113113123212

32311332332331132331111223313212312111212131311231132131131323321313332231211122

23122131111132231331133222312321332121233113122222323313132222211323221111321122

22221231323132212233123213312311321132113131212133333122311322122112313323231132

33133133232231113133111313123132232313232333231322331113113333323311312122212332

32222232133323323321221223312123311332132211233333231212121323113222323231123312

22321221112121233211231233322333312233321122231321323311221313133122131233323332

11213233122333231331322233213332321221232231132333312211113233323211313133311122

13211121112332212221331323112132222333331232321221122212321322231313311221113122

12231313122222233333113133121211123122121112311222131212131112111321112123323332

12111122313223313212112231231213223111132232122323321113313221222332121111122112

13312321222231323313211111332332122333221331212121123132221132231223233312312212

11113111321122232223231131132111131312121211212122313323213131231233332131232232

13223333323132211112322223122332132332312133131113323312132123221111212211223132

11212213112312112213213212132221133112332221322311233332331331112321221133121132

11111123333212121111222232232133223132112313212223131131322213233331212122221122

22222332311123221133122312232123213112123322211123313223231131233121223333112222

31221133313222333323323321333311223323322211232121313213122111121121132213122312

21332233132313311222113313123321132232333233112121333131233331121211113312333212

32121331222321313333312132212332212231333233311313221133132313133212322121213112

23331321311323233211321311112233132331311311232231213323111112122121221312312122

32221123113313131313133211312131223121232212113322322333121122323223122312222132

13311211331212311111211111212131222232313313321211123222113313133233332331121322

31123112332132122113221331312111232112233321312233221133313131211213231331331312

12332122333132132223122211131223133222311122312133111222312332233232133313113312

13211131331313322221222223323332221122111123111322121313231321312223311132333212

32311213331322331321211122112121333133222222121311233111223122231223312122323322

11132113123233122313133221112223323121213231123323222131212232232311123221212222

32222213131332231133213331311133123213221322333332233323131112112123321133323222

31212133332321233221333313111213312223122233222313122131133112233123223212313112

32222211112332123123131333112113211231131132233331132131223232123212113133221232

21113313213211132131321311231322231222132322322313213331223112121111121333323132

22232233331212211212312321123222113332233212231122332323223323232233131332211222

22221322111232332233332323222332332213131332331112221131133212322111121232121232

21332231323213212312112321113332111323123113332122131121131333131123122221231132

21312313312113312313131121233313212111122232323133132221333332223211333222113332

23331221113312312321131223322231132221321222322332332312121223123332122332132112

31222323112131332213123321331131133112123123311221213311132322133321122321231332

22111312213121211113331222332123122213131111131313333131222312321113111132131232

21212321331232313311313131212113331331121133121123112131111223133233231311212122

32133112123131223111123231311223213333321332131313133223332131212112221332213322

21121312133323311222112111322112221331233332321112122333132231311213113321332332

32222111212232213232111232112122113111132322112222332233321222232212221321221122

13111213332211112311213122231312232231321131113333131113222211332322322313233232

23322133213232131131311211112231322211333332121321131113131311212233323213223312

22221223123221312333223213231233132333331112122322213333322122333332233122121112

22332331222323213233212133332233321222312111212131313221231311331332213131123112

33321133131231123311112222311222231121331233332121212222211323223321222112113122

12212133123112331311111113331121121121113123132322221111323221333233212133132312

22121131311221233323332331132333111323223213211111222212231123133333232232233222

33223113311111213123132111333332133321231132223233312311133121111233312212112212

22133113332323231121231233232321211223233111122331122332132211121211332331212132

12131223131321131331331332333132223132132112221321312311331212222332223222322222

21232111133233313111113212321132121111111133123231313323322211121213121213232332

23332112211131311232313233222333211321123222323311132312223122321132321221221312

31231211222212133232231222332333122222231212333332322111332222131333113333133212

13113212321331133211122133211112331132223232231113321321113233323331333233222112

11111111111111111111111111111111111111111111111111111111111111111111111111111110